##################
#................#
#................#
#................#
#..........###...#
#.......#........#
#.....#..........#
#...#............#
#................#
##################

