##############################
#............................#
#.....................?......#
#..?.........................#
#..........###...............#
#.......#....................#
#.....#......................#
#...#........................#
#.......*......,....,.........#
##############################

