##################
#...........*....#
#................#
#................#
#..........###...#
#.......#........#
#.....#..........#
#...#............#
#..........?.....#
##################

