##################
#...........*....#
#................#
#................#
#..........###...#
#.......#........#
#.....#..........#
#...#......?.....#
#................#
##################

