############
#......*.#
#........#
#........#
#........#
#........#
#........#
#......?.#
#........#
############

