............................
............................
............................
............................
.....##################.....
.....#...........*....#.....
.....#................#.....
.....#................#.....
.....#..........###...#.....
.....#.......#........#.....
.....#.....#..........#.....
.....#...#......?.....#.....
.....#................#.....
.....##################.....
............................
............................
............................
............................

